f_ f_ f_ __ __ ft ft ft ft ft __ __ __ __ __ __ __ __ __ __ __ __ __ __ __ __ __ __ __ __ __ __ _t fw fw fw __ __ __ __ __ __ f_
f_ f_ f_ f_ f_ f_ f_ ft f_ f_ f_ e_ v_ __ __ __ __ __ __ __ __ __ __ __ __ __ __ __ __ __ __ __ _t fw f_ fw __ __ __ __ __ __ f_
f_ f_ e2 f_ f_ f_ f_ e_ e_ e_ et ft v_ v_ v_ v_ v_ v_ v_ v_ v_ v_ v_ v_ v_ eR __ __ __ __ __ __ _t f_ f_ f_ fw __ __ __ __ __ f_
__ f_ e_ e_ f_ f_ __ f_ e_ f_ f_ f_ e_ _t _t _t _t _t _t _t _t _t _t _t _t _t _t _t _t _t _t _t _t f_ f_ f_ f_ fw __ __ __ __ f_
__ f_ f_ e_ e_ f_ f_ f_ f_ __ __ __ __ __ __ __ __ __ __ __ __ __ __ __ __ __ __ __ __ __ __ __ __ f_ f_ f_ f_ f_ fw __ __ f_ f_
__ f_ f_ f_ e_ f_ ft ft f_ __ f_ f_ f_ f_ f_ f_ f_ f_ f_ f_ f_ f_ f_ f_ f_ f_ f_ f_ f_ f_ f_ ft ft f_ f_ f_ f_ f_ f_ fw fw f_ e_
__ f_ f_ f_ f_ f_ ft f_ e_ f_ f_ f_ f_ __ f_ f_ f_ ft f_ f_ f_ f_ f_ f_ f_ f_ ft ft f_ f_ f_ ft f_ f_ f_ f_ e_ e_ e_ e_ f_ f_ f_
ft ft f_ __ f_ f_ ft f_ e_ f_ f_ f_ f_ f_ f_ f_ __ f_ f_ f_ ft f_ f_ f_ f_ f_ f_ f_ ft ft f_ f_ f_ f_ f_ f_ _t f_ f_ f_ f_ f_ f_
__ f_ f_ f_ f_ f_ ft e_ f_ __ f_ f_ f_ f_ f_ ft ft ft f_ f_ f! f_ f_ f_ f_ f_ f_ f_ f_ f_ f_ f_ f_ f_ f_ f_ f_ f_ f_ f_ f_ f_ f_
__ f_ e_ e_ e_ f_ f_ e_ f_ __ __ __ __ f_ f_ f_ f_ f_ f_ f_ f_ f_ f_ f_ f_ f_ f_ f_ f_ f_ f_ f_ f_ f_ ft f_ f! f_ f_ f_ f_ f_ f_
__ f_ f_ f_ e_ f_ __ f_ f_ ft ft __ __ __ f_ f_ f_ f_ f_ f_ f_ f_ f_ f_ f_ f_ f_ f_ f_ f_ f_ f_ f_ f_ f_ f_ f_ f_ f_ ft f_ f_ f_
__ f_ f_ f_ f_ f_ f_ f_ f_ f_ f_ f_ f_ f_ f_ f_ fw fw fw fw fw fw fw fw fw fw fw fw fw fw fw fw f_ f_ f_ f_ f_ f_ f_ f_ f_ f_ f_
__ f_ f_ e_ et ft __ __ __ f_ f_ et f_ f_ f_ f_ fw __ __ __ __ __ __ __ __ __ __ __ __ __ __ fw f_ f_ f_ f_ f_ f_ f_ f_ f_ f_ f_
__ f_ e_ e_ e_ __ __ f_ f_ f_ f_ f_ f_ f_ f_ f_ e_ e_ e_ ft __ __ __ __ __ __ __ __ __ __ f_ f_ f_ f_ f_ f_ f_ f_ f_ f_ f_ f_ f_
__ f_ __ __ __ __ __ __ __ __ __ __ __ __ fw e_ e_ e_ e_ __ __ __ __ __ __ __ __ __ f_ f_ f_ f_ ft f_ f_ f_ f_ f_ f_ f_ f_ f_ f_
__ f_ __ __ __ __ __ __ __ __ __ __ __ __ __ ew e_ e_ e_ __ __ __ __ __ __ __ __ __ __ __ f_ f_ f_ f_ f_ f_ f_ f_ __ __ __ __ __
__ f_ __ __ __ __ __ __ __ __ __ __ __ __ ew e_ eC e_ e_ _t _t __ __ __ __ __ __ __ __ __ __ f_ f_ f_ f_ f_ f_ __ __ __ __ __ __
__ f_ __ __ __ __ __ _t l_ _t __ __ __ __ __ ew ew e_ e_ _t __ __ __ __ __ __ __ __ __ __ __ __ __ _t f_ f_ f_ __ __ __ _t __ __
__ fC __ __ __ __ __ l_ lG l_ __ __ __ __ __ __ ew f_ f_ fw __ __ __ __ __ __ __ __ __ __ __ __ __ f_ f_ f_ f_ __ __ __ _t __ __
__ ew __ __ __ __ __ _t l_ _t __ __ __ __ __ __ __ f_ f_ f_ fw fw fw fw fw fw fw __ __ __ __ fw f_ f_ __ __ __ __ __ __ __ __ __
__ __ v_ v_ v_ v_ v_ v_ v_ __ __ __ __ __ __ __ __ f_ f_ f_ f_ ft ft f_ f_ f_ f_ fw fw fw fw f_ f_ f_ e_ f_ f_ f_ f_ f_ __ __ __
__ __ v_ __ __ __ __ __ __ __ __ __ __ __ __ f_ f_ f_ f_ f_ ft f_ f_ f_ f_ f_ f_ f_ f_ f_ f_ f_ f_ e_ f_ f_ f_ f_ f_ f_ f_ __ __
v_ v_ v_ __ __ __ __ __ __ __ __ __ __ __ f_ f_ f_ e_ e_ f_ f_ f_ f_ f_ f_ f_ f_ f_ f_ e_ e_ f_ f_ f_ f_ f_ f_ f_ f_ f_ f_ f_ f_
v_ __ __ __ __ __ e_ f_ f_ f_ f_ f_ f_ f_ f_ f_ f_ f_ e_ e_ f_ f_ f_ f_ f_ f_ f_ f_ f_ f_ e_ f_ f_ f_ f_ f_ f_ __ __ __ __ __ __
v_ __ __ __ __ e_ f_ f_ f_ f_ f_ f_ f_ f_ f_ fw fw fw fw fw fw fw fw f_ fw fw fw fw fw fw fw fw f_ f_ f_ f_ f_ __ __ __ __ __ __
v_ __ __ __ e_ e_ __ __ __ __ __ __ __ __ __ __ __ __ __ __ __ __ ew f_ ew __ __ __ __ __ __ __ f_ f_ f_ f_ f_ __ __ __ __ __ __
v_ __ __ __ e_ __ __ __ __ __ __ __ __ __ __ __ __ __ __ __ __ __ ew f_ ew __ __ __ __ __ __ f_ f_ f_ f_ f_ f_ __ __ __ __ __ __
v_ __ e_ f_ f_ __ __ __ __ __ __ __ __ __ __ __ __ __ __ __ __ __ ew f_ ew __ __ __ __ __ __ f_ f_ f_ f_ f_ __ __ __ __ __ __ __
v_ _t f_ f_ __ __ __ __ __ __ __ __ __ __ __ __ __ __ __ __ __ __ ew f_ ew __ __ __ __ __ __ f_ f_ f_ f_ f_ __ __ __ __ __ __ __
v_ __ __ __ __ __ __ __ __ __ __ __ __ __ __ __ __ __ __ __ lw lw l_ fp l_ lw __ __ __ __ f_ f_ f_ f_ f_ f_ f_ f_ __ __ __ __ __
v_ v_ v_ v_ v_ v_ v_ v_ v_ v_ v_ v_ v_ v_ v_ v_ v_ v_ v_ v_ v_ v_ v_ lw __ __ __ __ __ __ __ f_ f_ f_ f_ f_ f_ f_ __ __ __ __ __
__ __ __ __ __ __ __ __ __ __ __ __ __ __ __ __ __ __ __ __ __ __ __ __ __ __ __ __ __ f_ f_ f_ f_ f_ f_ f_ f_ f_ f_ f_ f_ f_ f_
__ __ __ __ __ __ __ __ __ __ __ __ __ __ __ __ __ __ __ __ __ __ __ __ f_ f_ f_ f_ f_ f_ f_ f_ f_ f_ f_ f_ f_ f_ f_ f_ f_ f_ f_
__ __ __ __ __ __ __ __ __ __ __ __ __ __ e? __ __ __ __ __ __ __ __ __ f_ f_ f_ f_ f_ f_ f_ f_ f_ f_ f_ f_ f_ f_ f_ f_ f_ __ __
__ __ __ __ __ __ __ __ __ __ __ __ __ __ __ __ __ __ __ __ __ __ __ __ f_ f_ f_ f_ f_ f_ f_ f_ f_ f_ f_ f_ f_ f_ f_ f_ f_ __ __
f_ f_ f_ f_ f_ f_ f_ f_ f_ f_ f_ f_ f_ f_ f_ f_ f_ f_ f_ f_ f_ f_ f_ f_ f_ f_ f_ f@ f_ f_ f_ f_ f_ f_ f_ f_ f_ f_ f_ f_ f_ f_ __
f_ f_ f_ f_ f_ f_ f_ f_ f_ f_ f_ f_ f_ f_ f_ f_ f_ f_ f_ f_ f_ f_ f_ f_ f_ f_ f_ f@ f_ f_ f_ ft f_ f_ f_ f_ f_ e_ e_ e_ f_ f_ f_
f_ f_ f_ f_ f_ f? f_ f_ f_ f_ f_ f_ f_ f_ f_ f_ f_ f_ f_ f_ f_ f_ f_ f_ f_ f_ f_ f@ f_ f_ ft ft f_ f_ f_ f_ f_ f_ f_ e_ e_ f_ f_
f_ f_ f_ f_ e_ f_ f_ f_ f_ f_ f_ f_ f_ f_ f_ f_ f_ f_ f_ f_ f! f_ f_ f_ f_ f_ f_ f@ f_ f_ ft ft ft f_ f_ f_ f_ f_ f_ f_ f_ f_ f_
f_ f_ f_ f_ e_ f_ f_ f_ f_ f_ f_ f_ f_ f_ f_ f_ f_ f_ f_ f_ f_ f_ f_ f_ f_ f_ f_ f@ f_ f_ ft ft ft f_ f_ f_ f_ f_ f_ f_ f_ f_ f_
f_ f_ f_ e_ e_ ft f_ f_ f_ f_ f_ f_ f_ f_ f_ f_ f_ f_ f_ f_ f_ f_ f_ f_ f_ f_ f_ f@ f_ f_ f_ f_ f_ f_ f_ f_ f_ f_ f_ f_ f_ f_ f_
f_ f_ ft e_ fw fw f_ f_ f_ f_ f_ f_ f_ f_ f_ f_ f_ f_ f_ f_ f_ f_ f_ f_ f_ f_ f_ f_ f_ f_ f_ f_ f_ f_ f_ f_ f_ f_ f_ f_ f_ f_ f_
f_ ft f_ e_ e_ e_ e_ __ __ __ __ __ __ f_ f_ f_ f_ f_ f_ f_ f_ f_ f_ f_ f_ f_ f_ f_ f_ f_ f_ f_ f_ f_ f_ f_ f_ f_ f_ f_ f_ f_ f_
f_ f_ f_ ft f_ fw e_ __ __ __ __ __ __ f_ f_ f_ f_ f_ f_ f_ f_ f_ f_ f_ f_ f_ f_ f_ f_ f_ f_ f_ f_ f_ f_ __ __ f_ f_ f_ f_ f_ f_
f_ f_ f_ f_ ft fw e_ e_ __ __ __ _t _t __ f_ f_ f_ f_ f_ f_ f_ f_ f_ f_ f_ f_ f_ fw fw fw fw fw fw f_ f_ f_ __ __ __ f_ f_ f_ f_
f_ f_ f_ ft f_ ft f_ e_ e_ e_ e_ e_ e_ e_ e_ e_ ft fw fw fw fw fw ft fw fw fw fw fw e_ e_ e_ e_ e_ lG f_ f_ __ __ __ f_ f_ f_ f_
f_ ft f_ f_ f_ ft f_ ft ft fw ft fw fw ft ft e_ f_ f_ f_ f_ f_ f_ f_ fw e_ e_ e_ e_ e_ ft ft fw fw f_ f_ f_ f_ f_ f_ f_ f_ f_ f_
f_ f_ ft f_ f_ f_ ft f_ f_ f_ f_ ft f_ f_ ft e_ e_ e_ e_ e_ e_ e_ e_ e_ e_ ft ft ft ft ft f_ f_ f_ f_ f_ f_ f_ f_ f_ f_ f_ f_ f_
f_ f_ f_ f_ f_ f_ f_ f_ f_ f_ f_ f_ f_ f_ ft fw fw fw fw fw fw fw ft ft fw ft f_ f_ f_ f_ f_ f_ f_ f_ f_ f_ f_ f_ f_ f_ f_ f_ f_