f_ f_ f_ __ __ ft ft ft ft ft __ __ __ __ __
f_ f_ f_ f_ f_ f_ f_ ft f_ f_ f_ f_ l_ __ __
f_ f_ e_ f_ f_ f_ f_ e_ e_
__ f_ e_ e_ f_ f_ __ f_ e_
__ f_ f_ e_ e_ f_ f_ f_ f_
__ f_ f_ f_ e_ ft ft ft f_
__ f_ f_ f_ ft ft ft f_ e_
ft ft f_ __ ft ft ft f_ e_
__ f_ f_ f_ f_ f_ ft e_ f_
__ f_ l_ f_ f_ f_ f_ e_ l_
__ f_ f_ f_ l_ f_ __ f_ f_
__ f_ f_ f_ f_ f_ f_ f_ f_
