s_ s_ s_ g_ g_ g_ g_ gr
s_ s_ s_ __ __ g_ g_ g_ g_ g_ g_ g_ g_ s_ g_
s_ s1 g_ g_ __ g_ g_ g_ g_ g_ g_ g_ g_ s_ g_ sC
s_ s_ g_ g_ g_ g_ g_ s_ s_ s_ s_ g_
sr sr s_ g_ g_ g_ s_ s_ sr g_ g_ g_ g_ s_ gr __ __ __ __ __ __ __
__ __ s_ __ __ g_ g_ __ __ __ __ __ __ __ __ g_ s_ sr s_ g_ g_ g_ g_ g_ __ __ __ __ __ __ g_ gr
__ __ s_ __ __ g_ g_ __ __ __ g_ g_ sr s_ g_ g_ g_ g_ __ __ __ __ g_ g_ s_ s_ s_
__ __ g_ __ __ g_ g_ g_ g_ g_ g_ gr g_ g_ g_ g_ g_ g_ __ __ s_ s_
__ __ g_ __ __ g_ g_ g_ g_ g_ g_ g_ g_ g_ g_ g_ gr g_ g_ g_ g_ g_ s_ sr s_ g_ g_ g_ g_ g_ __ __ __ __ __ __ g_ gr
__ __ g_ __ __ g_ g_ sr s_ g_ g_ g_ g_ __ __ __ __ g_ g_ s_ s_ s_
__ s_ g_ __ __ g_ g_ g_ g_ g_ g_ gr g_ g_ g_ g_ g_ g_ __ __ s_ s_
__ g_ gr __ __ g_ g_ g_ g_ g_ g_ g_ g_ g_ g_ g_ gr g_ g_ g_ g_
__ g_ __ __ __ __ __ __ __ __ g_ g_ g_ g_ g_ g_ g_ g_ g_ g_ g_ g_ g_
g_ g! g_ __ __ g_ g_ g_ g_ g_ g_ g_ g_ g_ g_ g_ g_ g_
g_ gr g_ g_ g_ g_ g_ g_ gr g_ g_ g_ g_ g_ g_ g_ g_ g_ g_ g_ s_ s_ s_ g_ g_ g_ g_ g_ g_ g_ g_ g_ g! g_ g_ g_ g_ g_ g_ g_
gr g_ g_ g_ g_ g_ g_ gr g_ g_ g_ g_ g_ g_ g_ s_ s_ s_ sr sr sr __ __ __ __ __ __ __ __ __ __ __ __ __ __ __ __ __ __ g_
g_ g_ g_ g_ g_ g_ g_ g_ s_ g_ s_ s_ s_ s_ s_ __ __ s_ sr v_ s_ s_ s_ v_ v_ v_ __ __ __ __ __ __ __ __ __ __ __ __ __ g_
g_ g_ g_ g_ g_ g_ g_ g_ s_ g_ s_ g_ s_ s_ sr g_ g_ g_ g_ s_ gr __ __ __ __ v_ v_ v_ v_ __ __ __ __ __ __ __ __ __ __ g_
g_ g_ g_ g_ g_ g_ g_ s_ s_ s_ s_ g_ g_ s? s_ sr g_ g_ g_ g_ s_ gr __ __ __ __ __ __ v_ __ __ __ __ __ __ __ __ __ __ g_
g_ s_ s_ sr g_ g_ g_ g_ s_ gr __ __ __ __ __ __ __ g_ s_ s_ sr g_ g_ g_ g_ s_ gr __ v_ __ __ __ __ __ __ __ __ __ __ g_
g_ s_ sr s_ g_ g_ g_ g_ g_ __ __ __ __ __ __ g_ gr __ __ __ __ __ __ __ __ __ __ __ v_ __ __ __ __ __ __ __ __ __ __ g_
g_ g_ sr s_ g_ g_ g_ g_ __ __ __ __ g_ g_ s_ s_ s_ __ __ __ __ __ __ __ __ __ __ __ v_ __ __ __ __ __ __ __ __ __ __ g_
g_ g_ g_ g_ g_ g_ gr g_ g_ g_ g_ g_ g_ __ __ s_ s_ __ __ __ __ __ __ __ __ __ __ __ v_ __ __ __ __ __ __ __ __ __ __ g_
g_ g_ g_ g_ g_ g_ g_ g_ g_ g_ g_ gr g_ g_ g_ g_ g_ s_ sr s_ g_ g_ g_ g_ g_ __ __ __ v_ v_ v_ g_ gG __ __ __ __ __ g? g_
__ __ __ __ __ g_ g_ sr s_ g_ g_ g_ g_ __ __ __ __ g_ g_ s_ s_ s_ __ __ __ __ __ __ __ __ __ __ __ __ __ __ __ __ __ g_
g_ g_ g_ g_ g_ g_ gr g_ g_ g_ g_ g_ g_ __ __ s_ s_ __ __ __ __ __ __ __ __ __ __ __ __ __ __ __ __ __ __ __ __ __ __ g_
g_ g! g_ g_ g_ g_ g_ g_ g_ g! g_ g_ gr gr gr gr __ __ __ __ __ __ __ __ __ __ __ __ __ __ __ __ __ __ __ __ __ __ __ g_
g! g_ g_ g_ g_ g_ g_ g_ g! g_ g_ g_ gr __ __ __ __ __ __ __ __ __ __ __ __ __ __ __ __ __ __ __ __ __ __ __ __ __ __ g_
g_ g_ g_ g_ g! g! g_ g_ g_ g_ g_ g_ gr __ __ __ __ __ __ __ __ __ __ __ __ __ __ __ __ __ __ __ __ __ __ __ __ __ __ g_
g_ gr g_ g_ g_ g! g_ g_ gr g_ g_ gC gr __ __ __ __ __ __ __ __ __ __ __ __ __ __ __ __ __ __ __ __ __ __ __ __ __ __ g!
g_ gr gr gr gr gr gr gr gr gr gr gr gr __ __ __ __ __ __ __ __ __ __ __ __ __ __ __ __ __ __ __ __ __ __ __ __ __ __ g_
g_ g_ g_ gr gr gr gr gr gr gr gr gr gr __ __ __ __ __ __ __ __ __ __ __ __ __ __ __ __ __ __ __ __ __ __ __ __ __ __ g_
gr gr g_ gr gr gr gr gr gr gr gr gr gr __ __ __ __ __ __ __ __ __ __ __ __ __ __ __ __ __ __ __ __ __ __ __ __ __ __ g_
g_ g_ g_ gr gr gr gr gr gr gr gr gr gr __ __ __ __ __ __ __ __ __ __ __ __ __ __ __ __ __ __ __ __ __ __ __ __ __ __ g_
g_ gr gr gr gr gr gr gr gr gr gr gr gR __ __ __ __ __ __ __ __ __ __ __ __ __ __ __ __ __ __ __ __ __ __ __ __ __ __ g_
g_ gr gr gr gr gr gr gr gr gr gr gr g_ __ __ __ __ __ __ __ __ __ __ __ __ __ __ __ __ __ __ __ __ __ __ __ __ __ __ g_
g_ gr gr gr gr gr gr gr gr gr gr gr g_ __ __ __ __ __ __ __ __ __ __ __ __ __ __ __ __ __ __ __ __ __ __ __ __ __ __ g_
g_ gr gr gr gr gr gr gr gr gr gr gr g_ __ __ __ __ __ __ __ __ __ __ __ __ __ __ __ __ __ __ __ __ __ __ __ __ __ __ g_
g_ gr gr gr gr gr gr gr gr gr gr gr g_ __ __ __ __ __ __ __ __ __ __ __ __ __ __ __ __ __ __ __ __ __ __ __ __ __ __ g_
g_ gr gr gr gr gr gr gr gr gr gr gr g_ __ __ __ __ __ __ __ __ __ __ __ __ __ __ __ __ __ __ __ __ __ __ __ __ __ __ g_
g_ gr gr gr gr gr gr gr gr gr gr gr g_ __ __ __ __ __ __ __ __ __ __ __ __ __ __ __ __ __ __ __ __ __ __ __ __ __ __ g_
g_ g_ gr gr gr gr gr gr gr gr gr gr g_ __ __ __ __ __ __ __ __ __ g? g? g? __ __ __ __ __ __ __ __ __ __ __ __ __ __ g_
gr gp gr gr gr gr gr gr gr gr gr gr g_ g_ g_ g_ g_ g_ g_ g_ g_ g_ g_ g_ g_ g_ g_ g_ g_ g_ g_ g_ s_ s! s_ s_ s_ s_ s_ g_
gr gr gr