f_ f_ f_ __ __ fw fw fw fw fw __ __ __ __ __ __ __ __ __ __ __ __ __ __ __ __ __ __ __ __ __ __ _w fw fw fw __ __ __ __ __ __ f_
f_ f_ f_ f_ f_ f_ f_ fw f_ f_ f_ e_ v_ __ __ __ __ __ __ __ __ __ __ __ __ __ __ __ __ __ __ __ _t fw f_ fw __ __ __ __ __ __ f_
f_ f_ e2 f_ f_ f_ f_ e_ e_ e_ et ft v_ v_ v_ v_ v_ v_ v_ v_ v_ v_ v_ v_ v_ eC __ __ __ __ __ __ _w f_ f_ f_ fw __ __ __ __ __ f_
__ f_ e_ e_ f_ f_ __ f_ e_ f_ f_ f_ e_ _w _t _w _t _w _t _w _t _w _t _w _t _w _t _w _t _w _t _w _t f_ f_ f_ f_ fw __ __ __ __ f_
__ f_ f_ e_ e_ f_ f_ f_ f_ __ __ __ __ __ __ __ __ __ __ __ __ __ __ __ __ __ __ __ __ __ __ __ __ f_ f_ f_ f_ f_ fw __ __ f_ f_
__ f_ f_ f_ e_ f_ ft ft f_ __ f_ f_ f_ f_ f_ f_ f_ f_ f_ f_ f_ f_ f_ f_ f_ f_ f_ f_ f_ f_ f_ ft ft f_ f_ f_ f_ f_ f_ fw fw f_ e_
__ f_ f_ f_ f_ f_ ft f_ e_ f_ f_ f_ f_ __ f_ f_ f_ ft f_ f_ f_ f_ f_ f_ f_ f_ ft ft f_ f_ f_ ft f_ f_ f_ f_ e_ e_ e_ e_ f_ f_ f_
ft ft f_ __ f_ f_ ft f_ e_ f_ f_ f_ f_ f_ f_ f_ __ f_ f_ f_ ft f_ f_ f_ f_ f_ f_ f_ ft ft f_ f_ f_ f_ f_ f_ _t f_ f_ f_ f_ f_ f_
__ f_ f_ f_ f_ f_ ft e_ f_ __ f_ f_ f_ f_ f_ ft ft ft f_ f_ f@ f_ f_ f_ f_ f_ f_ f_ f_ f_ f_ f_ f_ f_ f_ f_ f_ f_ f_ f_ f_ f_ f_
__ f_ e_ e_ e_ f_ f_ e_ f_ __ __ __ __ f_ f_ f_ f_ f_ f_ f_ f_ f_ f_ f_ f_ f_ f_ f_ f_ f_ f_ f_ f_ f_ ft f_ f@ f_ f_ f_ f_ f_ f_
__ f_ f_ f_ e_ f_ __ f_ f_ ft ft __ __ __ f_ f_ f_ f_ f_ f_ f_ f_ f_ f_ f_ f_ f_ f_ f_ f_ f_ f_ f_ f_ f_ f_ f_ f_ f_ ft f_ f_ f_
__ f_ f_ f_ f_ f_ f_ f_ f_ f_ f_ f_ f_ f_ f_ f_ fw fw fw fw fw fw fw fw fw fw fw fw fw fw fw fw f_ f_ f_ f_ f_ f_ f_ f_ f_ f_ f_
__ f_ f_ e_ ew fw fw __ __ f_ f_ et f_ f_ f_ f_ fw __ __ __ __ __ __ __ __ __ __ __ __ __ __ fw f_ f_ f_ f_ f_ f_ f_ f_ f_ f_ f_
__ f_ ew ew ew __ __ fw fw fw fw f_ f_ f_ f_ f_ e_ e_ e_ ft __ __ __ __ __ __ __ __ __ __ f_ f_ f_ f_ f_ f_ f_ f_ f_ f_ f_ f_ f_
__ f_ __ __ __ __ __ __ __ __ __ __ __ __ fw e_ e_ e_ e_ __ __ __ __ __ __ __ __ __ f_ f_ f_ f_ ft f_ f_ f_ f_ f_ f_ f_ f_ f_ f_
__ f_ __ __ __ __ __ __ __ __ __ __ __ __ __ ew e_ e_ e_ __ __ __ __ __ __ __ __ __ __ __ f_ f_ f_ f_ f_ f_ f_ f_ __ __ __ __ __
__ f_ __ __ __ __ __ l_ l_ l_ __ __ __ __ ew e_ eC e_ e_ _t _t __ __ __ __ __ __ __ __ __ __ f_ f_ f_ f_ f_ f_ __ __ __ __ __ __
__ f_ __ __ __ __ l_ l_ l/ l_ l_ __ __ __ __ ew ew e_ e_ _t __ __ __ __ __ __ __ __ __ __ __ __ __ _t f_ f_ f_ __ __ __ _t __ __
v_ f_ __ __ __ l_ l/ lC l_ lR l/ l_ __ __ __ __ ew f_ f_ fw __ __ __ __ __ __ __ __ __ __ __ __ __ f_ f_ f_ f_ __ __ __ _t __ __
v_ ew __ __ __ l_ l_ l_ l_ l_ l_ l_ __ __ __ __ __ f_ f_ f_ fw fw fw fw fw fw fw __ __ __ __ fw f_ f_ __ __ __ __ __ __ __ __ __
v_ __ v_ v_ v_ v_ v_ v_ v_ v_ v_ __ __ __ __ __ __ f_ f_ f_ f_ ft ft f_ f_ f_ f_ fw fw fw fw f_ f_ f_ e_ f_ f_ f_ f_ f_ __ __ __
v_ __ v_ v_ v_ v_ v_ v_ v_ __ __ __ __ __ __ f_ f_ f_ f_ f_ ft f_ f_ f$ f_ f_ f_ f_ f_ f_ f_ f_ f_ e_ f_ f_ f_ f_ f_ f_ f_ __ __
v_ v_ v_ v_ __ __ __ __ __ __ __ __ __ __ f_ f_ f_ e_ e_ f_ f_ f_ f_ f_ f_ f_ f_ f_ f_ e_ e_ f_ f_ f_ f_ f_ f_ f_ f_ f_ f_ f_ f_
v_ v_ __ __ __ __ e_ f_ f_ f_ f_ f_ f_ f_ f_ f_ f_ f_ e/ e_ f_ f_ f_ f_ f_ f_ f_ f_ f_ f_ e_ f_ f_ f_ f_ f_ f_ __ __ __ __ __ __
v_ __ __ __ __ e_ f_ f_ f_ f_ f_ f_ f_ f_ f_ fw fw fw fw fw fw fw fw f_ fw fw fw fw fw fw fw fw f_ f_ f_ f_ f_ __ __ __ __ __ __
v_ __ __ __ e_ e_ __ __ __ __ __ __ __ __ __ __ __ __ __ __ __ __ ew f_ ew __ __ __ __ __ __ __ f_ f_ f_ f_ f_ __ __ __ __ __ __
v_ __ __ __ e_ __ __ __ __ __ __ __ __ __ __ __ __ __ __ __ __ __ ew f_ ew __ __ __ __ __ __ f_ f_ f_ f_ f_ f_ __ __ __ __ __ __
v_ __ e_ f_ f_ v_ __ __ __ __ __ __ __ __ __ __ __ __ __ __ __ __ ew f_ ew __ __ __ __ __ __ f_ f_ f_ f_ f_ __ __ __ __ __ __ __
v_ _t f_ f_ __ v_ __ __ __ __ __ __ __ __ __ __ __ __ __ __ __ __ ew f_ ew __ __ __ __ __ __ f_ f_ f_ f_ f_ __ __ __ __ __ __ __
v_ __ __ __ __ v_ __ __ __ __ __ __ __ __ __ __ __ __ __ __ lw lw l_ fp l_ lw __ __ __ __ f_ f_ f_ f_ f_ f_ f_ f_ __ __ __ __ __
v_ v_ v_ v_ v_ v_ v_ v_ v_ v_ v_ v_ v_ v_ v_ v_ v_ v_ v_ v_ v_ v_ v_ lw __ __ __ __ __ __ __ f_ f_ f_ f_ f_ f_ f_ __ __ __ __ __
__ __ __ __ __ __ __ __ __ __ __ __ __ __ __ __ __ __ __ __ __ __ __ __ __ __ __ __ __ f_ f_ f_ f_ f_ f_ f_ f_ f_ f_ f_ f_ f_ e_
__ __ __ __ __ __ __ __ __ __ __ __ __ __ __ __ __ __ __ __ __ __ __ __ f_ f_ f_ f_ f_ f_ f_ f_ f_ f_ f_ f_ f_ f_ f_ f_ f_ f_ e_ e_ e_ eC
__ __ __ __ __ __ __ __ __ __ __ __ __ __ e/ __ __ __ __ __ __ __ __ __ f_ f_ f_ f_ f_ f_ f_ f_ f_ f_ f$ f_ f_ f_ f_ f_ f_ __ __
__ __ __ __ __ __ __ __ __ __ __ __ __ __ __ __ __ __ __ __ __ __ __ __ f_ f_ f_ f_ f_ f_ f_ f_ f_ f_ f_ f_ f_ f_ f_ f_ f_ __ __
fw fw fw fw f_ f_ f_ f_ f_ f_ f_ f_ f_ f_ f_ f_ f_ f_ f_ f_ f_ f_ f_ f_ f_ f_ f_ f@ f_ f_ f_ f_ f_ f_ f_ f_ f_ f_ f_ f_ f_ f_ __
fw f_ f_ f_ f_ f_ f_ f_ f_ f_ f_ f_ f_ f_ f_ f_ f_ f_ f_ f_ f_ f_ f_ f_ f_ f_ f_ f@ f_ f_ f_ ft f_ f_ f_ f_ f_ e_ e_ e_ f_ f_ f_
fw f_ f_ f_ f_ f@ f_ f_ f_ f_ f_ f_ f_ f_ f_ f_ f_ f@ f_ f_ f_ f_ f_ f_ f_ f_ f_ f@ f_ f_ ft ft f_ f_ f_ f_ f_ f_ f_ e_ e_ f_ f_
fw f_ f_ f_ e_ f@ f@ f_ f_ f$ f_ f_ f_ f_ f_ f_ f_ f_ f_ f_ f@ f_ f_ f_ f_ f_ f_ f@ f_ f_ ft ft ft f_ f_ f_ f_ f_ f_ f_ f_ f_ f_
fw f_ f_ f_ e_ f_ f_ f_ f_ f_ f_ f_ f_ f_ f_ f_ f_ f_ f_ f_ f_ f_ f_ f_ f_ f_ f_ f@ f_ f_ ft ft ft f_ f_ f_ f_ f_ f_ f_ f_ f_ f_
fw f_ f_ e_ e_ ft f_ f_ f_ f_ f_ f_ f_ f_ f_ f_ f_ f_ f_ f_ f_ f_ f_ f_ f_ f_ f_ f@ f_ f_ f_ f_ f_ f_ f_ f_ f_ f_ f@ f_ f_ f_ f_
fw f_ ft e_ fw fw ft f_ f_ f_ f_ f_ f_ f_ f_ f_ f@ f@ f_ f_ f_ f_ f_ f_ f_ f_ f_ f_ f_ f_ f_ f_ f_ f_ f_ f_ f_ f_ f_ f_ f_ f_ f_
fw ft f_ e_ e_ e_ e_ __ __ __ __ __ __ f_ f_ f_ f_ f_ f_ f_ f_ f_ f_ f_ f_ f_ f_ f_ f_ f_ f_ f_ f_ f_ f_ f_ f_ f_ f_ f_ f_ f_ f_
fw f_ f_ ft f_ fw e_ __ __ __ __ __ __ f_ f_ f_ f_ f_ f_ f_ f_ f_ f_ f_ f_ f_ f_ f_ f_ f_ f_ f_ f_ f_ f_ __ __ f_ f_ f_ f_ f_ f_
fw f_ f_ f_ ft fw e_ e_ __ __ __ _t _t __ ft ft f_ f_ f_ f_ f@ f_ f_ f_ f_ f_ f_ fw fw fw fw fw fw fw f_ f_ __ __ __ f_ f_ f_ f_
fw f_ f_ ft f_ ft f_ e_ e_ e_ e_ e_ e_ e_ e_ e_ ft fw fw fw fw fw ft fw fw fw fw fw e_ e_ e_ e_ e_ lR fw f_ __ __ __ f_ f_ f_ f_
fw ft f_ f_ f_ ft f_ ft ft fw ft fw fw ft ft e_ f_ f_ f_ f_ f_ f_ f_ fw e_ e_ e_ e_ e_ ft ft fw fw fw f_ f_ f_ f_ f_ f_ f_ f_ f_
fw f_ ft f_ f_ f_ ft f_ f_ f_ f_ ft f_ f_ ft e_ e_ e_ e_ e_ e_ e_ e_ e_ e_ ft ft ft ft ft f_ f_ f_ f_ f_ f_ f_ f_ f_ f_ f_ f_ f_
fw fw fw fw f_ f_ f_ f_ f_ f_ f_ f_ f_ f_ ft fw fw fw fw fw fw fw ft ft fw ft f_ f_ f_ f_ f_ f_ f_ f_ f_ f_ f_ f_ f_ f_ f_ f_ f_